11111111111111111111
10000100000000000001
10000100000000000001
10000100000000000001
10000100000000000001
10000000000000000001
10000000000000000001
10000000000000000001
10000000000000000001
10000000000000000001
10000000000000100001
10000000000000100001
10000000000000100001
10000000000000100001
11111111111111111111
5